##############
#............#
#............#
#............#
#............#
#............#  ######
#............#  #....#
#............#  #....#
#............#  #....#
#............#  ######
#............#
#............#
##############
