####################################   	 
....................................   	 
...H...H........H........HH...HH....   	 
....H.H.........H.......H....H......   	 
.....H..HHH.H.H.H...HHH..HH..HH.....   	 
.....H..H.H.H.H.H...H.H....H.H......   	 
.....H..HHH.HHH.HHH.HHH..HH...HH.H..   	 
....................................   	 
####################################   	 
                                         
