####################################    
....................................    
...H...H................H......H....    
....H.H.........H.....H........H....    
.....H..HHH.H.H.H..H..H.H..HH..H....    
.....H..H.H.H.H.H..H..H.H.H..H......    
.....H..HHH.HHH..HH.HH..H.H..H.H....    
....................................    
####################################    
                                        
